3 1 1 1 1 1 1 1 1 1 1 1 1 1 1 3
2 6 6 6 6 6 6 6 6 6 6 6 6 6 6 2
2 7 7 7 7 7 7 7 7 7 7 7 7 7 7 2
2 7 7 7 7 7 7 7 7 7 7 7 7 7 7 2
2 7 7 7 7 7 7 7 7 7 7 7 7 7 7 2
2 7 7 7 7 7 7 7 7 7 7 7 7 7 7 2
2 7 7 7 7 7 7 7 7 7 7 7 7 7 7 2
2 4 4 4 4 4 4 4 4 4 4 4 4 4 4 2
2 4 4 4 4 4 4 4 4 4 4 4 4 4 4 2
2 4 4 4 4 4 4 4 4 4 4 4 4 4 4 2
2 4 4 4 4 4 4 4 4 4 4 4 4 4 4 2
3 1 1 1 1 1 1 1 1 1 1 1 1 1 1 3
